11111111111111111111111111111111111111111111111111
10000000555000000000000000000005550000000000000001
10000000000000000000000000000000000000000000000001
17000000000000000060000000000000000000000000060001
11110000000000001111100044400000000000000001111001
10000060000000000000000000000000000000000000000001
10001111100000000000000000000060000000000000000001
10000000000000000000005550011111044400000000000001
10000000000000004440000000000000000000000006000001
10000000000000000000000000000000000000000111100001
10000000000333000000000000000006000000000000000001
10000000000000000000022200001111100000000000000001
10000006000000000000000000000000000055500000000001
10001111100000000000000000000000000000000000000081
10000000000000000000000000000000000000000000011111
10000000000000000000000000000000000000000000000001
10004444000099900000444400009990000444400009990001
11111111cccc11111ddd1111cccc1111ddd1111cccc1111111
