1111111111111111111111111111111111111111111111111111111111111111111111
1055500000000000055500000000005550000000000555000000000055500000000001
1000000000000000000000000000000000000000000000000000000000000000000001
1000000600000000000000060000000000006000000000000600000000000060000001
1110011111004440001111100444001111100444001111100444001111100000000001
1000000000000000000000000000000000000000000000000000000000000000000001
1000003330000000000033300000000033300000000033300000000033300000000001
1000000000022000000000000220000000000220000000000220000000000000060001
1000000000000000000000000000000000000000000000000000000000000001111001
1000000000000000000000000000000000000000000000000000000000000000000001
1000000000000000000000000000000000000000000000000000000000000000000001
1700000000000000000000000000000000000000000000000000000000000000000001
1111100000000000000000000000000000000000000000000000000000000000000001
1000000000000000000000000000000000000000000000000000000000000000000001
1000000000000000000000000000000000000000000000000000000000000000000001
1000060000000000000600000000006000000000060000000000600000000000000001
1011111000004440111110044401111100444011111004440111110000000000000001
1000000000000000000000000000000000000000000000000000000000000000000001
1000000000000000000000000000000000000000000000000000000000000000000081
1000000000000000000000000000000000000000000000000000000000000000011111
1000000000000000000000000000000000000000000000000000000000000000000001
1000000000000000000000000000000000000000000000000000000000000000000001
1099900000999000049990000044409990000999000004440999000044400000000001
111111cccc1111ddd11111cccc11111111ddd1111cccc11111111ddd111cccc1111111
