1111111111111111111111111111111111111111111111111111111
1000055500000000000000000000000000000555000000000000001
1000000000000000000000000000000000000000000000000000001
1700000000000000000000000000000000000000000000000000001
1111000000060000000000000000006000000000000006000000001
1000000001111100044400000000111110044400000011111000001
1000000000000000000000000000000000000000000000000000001
1000000000000003330000000000000000000033300000000000001
1000000000000000000002220000000000000000000022200000001
1000060000000000000000000000000600000000000000000000001
1011111000000000000000000001111110000000000000000060001
1000000000000044400000000000000000000044400000001111001
1000000000000000000000000000000000000000000000000000001
1000000000000000000000033300000000000000000000000000001
1000000060000000000000000000000000006000000000000000001
1000001111100000000000000000000000111110000000000000081
1000000000000000000000000000000000000000000000000011111
1000000000000000000000000000000000000000000000000000001
1000099900000444000099900000444000099900000444000000001
111111111cccc111ddd11111cccc111ddd11111cccc111111111111
