11111111111111111111111111111111111111111111111111111111111111111
10005550000000000000000000555000000000000005550000000000000000001
10000000000000000000000000000000000000000000000000000000000000001
17000000000060000000000000000000006000000000000000006000000000001
11110000001111100444000000000000111110044400000001111100000000001
10000000000000000000000000000000000000000000000000000000000000001
10000000000000000000033300000000000000000003330000000000000000001
10000006000000000000000000002200000000000000000000220000000060001
10000111110000000000000000000000000000000000000000000000001111001
10000000000000000000000000000000000600000000000000000000000000001
10000000000000444000000000000011111100000000044400000000000000001
10000000000000000000000000000000000000000000000000000000000060001
10000000000000000000003330000000000000000000033300000000001111001
10000060000000000000000000002220000000000000000000022200000000001
10001111100000000000000000000000000000000000000000000000000000001
10000000000000000000000000000000000060000000000000000000000000001
10000000000000000000000000000000001111100000000000000000000000081
10000000000000000000000000000000000000000000000000000000000011111
10000000000000000000000000000000000000000000000000000000000000001
10000000000000000000000000000000000000000000000000000000000000001
10099900000444000099900000444000099900000444000099900000444000001
1111111cccc1111ddd1111cccc1111ddd1111cccc1111ddd1111cccc111111111
