111111111111111111111111111111111111111111111111111111111111111111111111111
100000000000000000000000000000000000000000000000000000000000000000000000001
100000000000000000000000000000000000000000000000000000000000000000000000001
170000000000000000000000000000000000000000000000000000000000000000000060001
111110000000000000000000000000000000000000000000000000000000000000001111101
100000000022200000000000000000000000000000000000000000000000060000000000001
100000000000000000033300000000000000000000000000000000000011111000000060001
100000000000000000000000000022200000000000000000000000000000000000001111101
100000000000000000000000000000000000033300000000000000000000000000000000001
100000000000060000000000000000000000000000000022200000000000000000000000001
100000000011111000000000000000000000000000000000000000033300000000000000001
100000000000000000000000000000000060000000000000000000000000000000000000001
100000000000000000000000000000001111100000000000000000000000000000000060001
100000000000000000033300000000000000000000000000000000000000000000001111001
100000000000000000000000000022200000000000000000000000000000000000000000001
100000000060000000000000000000000000000000000060000000000000000000000000001
100000001111100000000000000000000000000000011111000000000000000000000000001
100000000000000000000000000000000000000000000000000000000000000000000000001
100000000000000000000000000000000000000000000000000000000000000060000000001
100000000000000000000000000000000000000000000000000000000000011111000000001
100000000000000000000000000000000000000000000000000000000000000000000000001
100000000000000000000000000000000000000000000000000000000000000000000000001
100000000000000000000000000000000000000000000000000000000000000000000000081
100000000000000000000000000000000000000000000000000000000000000000000001111
100000000000000000000000000000000000000000000000000000000000000000000000001
100000000000000000000000000000000000000000000000000000000000000000000000001
100000044440000000000009990000000000044440000000000099900000004444000000001
111111111111111111111111111111111111111111111111111111111111111111111111111
