1111111111111111111111111111111111111111111111111111111111111111111111
1000000000000000000000000000000000000000000000000000000000000000000001
1000000000000000000000000000000000000000000000000000000000000000000001
1700000000000000000000000000000000000000000000000000000060000000000001
1111100000000000000000000000000000000000000000000000001111100000000001
1000000002220000000000000000000000000000000000000000000000000000060001
1000000000000000003330000000000000000000000000000000000000000011111001
1000000000000000000000000002220000000000000000000000000000000000000001
1000000000000060000000000000000000003330000000000000000000000000000001
1000000000011111000000000000000000000000000002220000000060000000000001
1000000000000000000000000000000060000000000000000000001111100000000001
1000000000000000000000000000001111100000000000000000000000000000000001
1000000000000000000000000000000000000000000000000060000000000000000001
1000000000000000000000000000000000000000000000011111100000000000000001
1000005550000000000000000000000000000000000000000000000000000000000001
1000000000000000000000000004440000000000000000000000000000000000000001
1000000000000000000060000000000000000000005550000000000000060000000001
1000000000000000011111000000000000000000000000000000000001111100000001
1000000000000000000000000000000000000000000000000000000000000000000001
1000000000000000000000000000000000000000000000000000000000000000000001
1000000000000000000000000000000000000000000000000000000000000000000081
1000000000000000000000000000000000000000000000000000000000000000011111
1000000000000000000000000000000000000000000000000000000000000000000001
1000000000000000000000000000000000000000000000000000000000000000000001
1000004444000000000000009990000000000000044440000000000009990000000001
1111111111cccc11111111111111111dddd11111111111cccc11111111111111111111
