1111111111111111111111111111111111111111111111111111111
1000000000000000000000000000000000000000000000000000001
1000000000000000000000000000000000000000000000000000001
1000000000000000000000000006000000000000000000000008001
1000000000000000000000000111100000000000000000000111101
1000000000006000000000000000000000000000000000000000001
1000000000111100000000000000000003330000006000000000001
1000000000000000000000000000000000000000011110000000001
1000000000000000022200000000000000000000000000000000001
1000000000000000000000000000000033300000000000000000001
1700000000000000000000000220000000000000000000000000001
1111100000000000000000000000000000000000000000000000001
1000000022200000000000000000000000000000000000000000001
1000000000000000000000000000000022200000000000000000001
1000000000000003330000000000000000000000000060000000001
1000000000000000000000000033300000000000011111000000001
1000000000000000000000000000000000000000000000000000001
1000000000000000000000000000000000000000000000000000001
1000000000000000000000000000000000000000000000000000001
1111111111111111111111111111111111111111111111111111111
