1111111111111111111111111111111111111111
1000000000000000000000000000000000000081
1000000000000000000000000000000000011111
1000000000000000000000000000006000000001
1000000000000000000000000000111110000001
1000000000000000000000000000000000000001
1000000000000000000006000000000000000001
1000000000000000000111100000000000000001
1000000000000000000000000000000000000001
1000000000000060000000000000000000000001
1000000000001111000000000000000000000001
1000000000000000000000000000000000000001
1000000060000000000000000000000000000001
1000001111100000000000000000000000000001
1000000000000000000000000000000000000001
1000000000000000000000033300000000000001
1000000000000000000000000000000000000001
1000000000000022200000000000000000000001
1000000000000000000000000000000000000001
1000000000000000000000000000006000000001
1000000000000000000000000000111100000001
1000000000000000000000000000000000000001
1000000000000000060000000000000000000001
1000000000000111110000000000000000000001
1000000000000000000000000000000000000001
1000000000000000000000022200000000000001
1000000000000000000000000000000000000001
1700000000000000000000000000000000000001
1111100000000000000000000000000000000001
1111111111111111111111111111111111111111
