1111111111111111111111111111111111111111111111111111111111111111111111
1000000000000000000000000000000000000000000000000000000000000000000001
1000000000000000000000000000000000000000000000000000000000000000000001
1700000000000000000000000000000000000000000000000000000000000000000001
1111100000000000000000000000000000000000000000000000000000000000000001
1000000000600000000000000000000060000000000000000000006000000000000001
1000000011111005550000000000001111100004440000000000111110000000000001
1000000000000000000000000000000000000000000000000000000000000000000001
1000000000000000000033300000000000000000000002220000000000000000000001
1000000000000000000000000000000000000000000000000000000000033300000001
1000000000000000000000000000000000000600000000000000000000000000000001
1000000000000022200000000000000001111100000000000000000000000000060001
1000000000000000000000000000000000000000000000000600000000000001111001
1000000000000000000000000033000000000000000000011111000000000000000001
1000000000000000000000000000000000000000000000000000000000000000000001
1000000600000000000000000000000000002220000000000000000006000000000001
1000011111000000000000000000000000000000000000000000000111110000000001
1000000000000000000000000000000000000000000000000000000000000000000001
1000000000000000000000000000000000000000000000000000000000000000000081
1000000000000000000000000000000000000000000000000000000000000000011111
1000000000000000000000000000000000000000000000000000000000000000000001
1000000000000000000000000000000000000000000000000000000000000000000001
1000000000000000000000000000000000000000000000000000000000000000000001
1000000000000000000000000000000000000000000000000000000000000000000001
1000099900000000444400000000000099900000000004444000000099900000000001
111111111cccc1111111ddd1111111111111cccc111111111ddd11111111cccc111111
