11111111111111111111111111111111111111111111111111
10000000000000000000000000000000000000000000000001
10000000000000000000000000000000000000000000000001
10000000000000000000000060000000000000000000000001
10000000000000000000011111100000000000000000000001
1000000600000000000000000000000000000000060000001
1000011111000000000000000000000000000001111100081
1000000000000000000000000000000001100000000011111
1000000000000011000000000000000000000000000000001
1000000000000000000000000000000000000000000000001
1700000000000000000000600000000000000000000000001
1111100000000000001111111000000000000000000000001
1000000000000000000000000000000011000000000000001
1000000001100000000000000000000000000011100000001
1000000000000000000000000000000000000000000000001
1000000000000000000000000000000000000000000000001
1000000000000000000000000000000000000000000000001
11111111111111111111111111111111111111111111111111
