111111111111111111111111111111111111111111111111111111111111111111111111111
100000000000000000000000000000000000000000000000000000000000000000000000001
100000000000000000000000000000000000000000000000000000000000000000000000001
170000000000000000000000000000000000000000000000000000000000000060000000001
111110000000000000000000000000000000000000000000000000000000001111100000001
100000000060000000000000000006000000000000000006000000000000000060000000001
100000001111100055500000000111110004440000001111100033300000001111100000001
100000000000000000000000000000000000000000000000000000000000000000000000001
100000000000000000002220000000000000000000000000000000002220000000000000001
100000000000000000000000000000000000000000000000000000000000000000000000001
100000000000000000000000000000000060000000000000000000000000000000000060001
100000000000000033300000000000001111100000000000003330000000000000001111001
100000000000000000000000000000000000000000000000000000000000000000000000001
100000000000000000000000022200000000000000000000000000002220000000000000001
100000060000000000000000000000000000000000000000000000000000000000000000001
100001111100000000000000000000000000000000000000000000000000000000000000001
100000000000000000000000000000000060000000000000000000000000000060000000001
100000000000000000000000000000001111100000000000000000000000001111100000001
100000000000000000000000000000000000000000000000000000000000000000000000001
100000000000000000000000000000000000000000000000000000000000000000000000001
100000000000000000000000000000000000000000000000000000000000000000000000081
100000000000000000000000000000000000000000000000000000000000000000000001111
100000000000000000000000000000000000000000000000000000000000000000000000001
100000000000000000000000000000000000000000000000000000000000000000000000001
100000000000000000000000000000000000000000000000000000000000000000000000001
100000000000000000000000000000000000000000000000000000000000000000000000001
100009990000004444000000009990000004444000000099900000044440000099900000001
111111111111111111111111111111111111111111111111111111111111111111111111111
