11111111111111111111111111111111111111111111111111111111111111111
10000000000000000000000000000000000000000000000000000000000000001
10000000000000000000000000000000000000000000000000000000000000001
10000000000000000000000000000000000000000000000000000000000008001
10000000000000000000000000000000000000000000000000000000000111001
10000006000000000000000000000000000000600000000000000000000000001
10000111110000000000000000000000000011111000000000000000330000001
10000000000000000000000000000000000000000000000000000000000000001
10000000000000222000000000000000000000000000003330000000000000001
10000000000000000000000000000000000000000000000000000000000000001
10000000000000000000001100000000000000000000000000000022200000001
17000000000000000000000000000000600000000000000000000000000060001
11111000000000000000000000000111111000000000000000000000001111001
10000000000000000000000000000000000000000033300000000000000000001
10000000000060000000000000000000000000000000000000000000000000001
10000000011111000000000000000000000000000000000022200000000000001
10000000000000000000000000000000000000000000000000000000000000001
10000000000000000000033300000000000000000000000000000000000060001
10000000000000000000000000000000000000110000000000000000001111101
10000000000000002220000000000000000000000000000000000000000000001
10000000000000000000000000000000000000000000000000000000000000001
10000000000000000000000000000000000000000000000000000000000000001
10000000000000000000000000000000000000000000000000000000000000001
11111111111111111111111111111111111111111111111111111111111111111
