11111111111111111111111111111111111111111111111111111111111111111
10000000000000000000000000000000000000000000000000000000000000001
10000000000000000000000000000000000000000000000000000000000000001
17000000000000000000000000000000000000000000000000000000000060001
11111000000000000000000000000000000000000000000000000000001111101
10000000022200000000000000000000000000000000000000000000000000001
10000000000000000033300000000000000000000000000000000000000060001
10000000000000000000000000022200000000000000000000000000001111101
10000000000000000000000000000000000033300000000000000000000000001
10000000060000000000000000000000000000000000022200000000000000001
10000001111100000000000000000000000000000000000000000033300000001
10000000000000000000000000000060000000000000000000000000000000001
10000000000000000000000000001111100000000000000000000000000060001
10000000000000033300000000000000000000000000000000000000001111001
10000000000000000000000022200000000000000000000000000000000000001
10000060000000000000000000000000000000000000060000000000000000001
10001111100000000000000000000000000000000011111000000000000000001
10000000000000000000000000000000000000000000000000000000000000001
10000000000000000000000000000000000000000000000000000000000000081
10000000000000000000000000000000000000000000000000000000000011111
10000000000000000000000000000000000000000000000000000000000000001
10000000000000000000000000000000000000000000000000000000000000001
10000000000000000000000000000000000000000000000000000000000000001
11111cccc11111111111111111111111111111111dddd1111111111111111111
