111111111111111111111111111111111111111111111111111111111111
100000000000000000000000000000000000000000000000000000000001
100000000000000000000000000000000000000000000000000000000001
170000000000000000000000000000000000000000000000000000000001
111110000000000000000000000000000000000000000000000000000001
100000000006000000000000000000060000000000000000060000000001
100000000111110000000055500011111000004440000011111000000001
100000000000000000000000000000000000000000000000000000000001
100000000000000033300000000000000002220000000000000000000001
100000000000000000000000000000000000000000000000000033000001
100000000000000000000000022000000000000000000000000000060001
100000006000000000000000000000000000000000000000000001111001
100000111110000000000000000000000600000000000000000000000001
100000000000000000000000000000111110000000000000000000000001
100000000000000000000000000000000000000000000006000000000001
100000000000002220000000000000000000000000001111100000000001
100000000000000000000000033300000000000000000000000000000001
100000000000000000000000000000000000000000000000000000000081
100000000000000000000000000000000000000000000000000000011111
100000000000000000000000000000000000000000000000000000000000001
100000000000000000000000000000000000000000000000000000000000001
111111cccc1111111ddd111111cccc1111111ddd11111cccc111111111111
