1111111111111111111111111111111111111111111111111111111
1000000000000000000000000000000000000000000000000000001
1000000000000000000000000000000000000000000000000000001
1700000000000000000000000000000000000000000000000000001
1111110000000000000000000000000000000000060000000000001
1000001111100000001111000000000000000011111100000000001
1000000000000000000000000006000000000000000000000000001
1000000000000000000000001111110000000000000000000000001
1000000000001111000000000000000000001111000000000000001
1000060000000000000000000000000000000000000006000000001
1011111000000000000011100000000000000000000111110000001
1000000000000000000000000000011100000000000000000000001
1000000000011100000000000060000000000000000000000000001
1000000000000000000000001111100000000000001110000000001
1000000000000000000000000000000000000000000000000060001
1000001111000000000000000000000000001100000000001111101
1000000000000006000000000000000000000000000000000000001
1000000000001111110000000000011100000000000000000000081
1000000000000000000000000000000000000000000000000011111
1000000000000000000000000000000000000000000000000000001
1000000000000000000000000000000000000000000000000000001
1111111111111111111111111111111111111111111111111111111
