111111111111111111111111111111111111111111111111111111111111
100000000000000000000000000000000000000000000000000000000001
100000000000000000000000000000000000000000000000000000000001
100000000000000000000000000000000000000000000000000000000081
100000000000000000000000000000000000000000000000000000111111
100000000000000060000000000000000600000000000000000000000001
100000000001111111100000000000111111000000000000001100000001
100000000000000000000000000000000000000000000000000010000001
100000000000000000000000000000000000000000000000000010060001
100000000000000000001100000000000000001100000000000010111001
100000000000000000000000000000000000000000000000000010000001
170000000000000000000000000000000000000000000600000010000001
111110000000000000000000011000000000000001111110000010000001
100000000000000000000000000000000000000000000000000010000001
100001000000000000000000000000000000000000000000000010000001
100001000000000000000000000000000000000000000000000000000001
100001000000006000000000000000000000000000000000000000000001
100001000000111110000000000000000000060000000000000000000001
100001000000000000000000000000000011111100000000000000000001
100000000000000000000000000000000000000000000000000000000001
100000000000000000000000000000000000000000000000000000000001
111111111111111111111111111111111111111111111111111111111111
