1111111111111111111111111111111111111111111111111111111111111111111111
1000000000005555000000000000000000000000000000000000000000000000000001
1000000000000000000000000000000000000000000000000000000000000000000001
1000000000000000000000000000000000000000000000000000000000000000000001
1000000000000000000000000000006000000000000000000000000000000000000001
1000000060000000000000000000111110000000000000000060000000000000008001
1000001111100000000000000000000000000000000000001111100000000000011101
1000000000000000000000000000000000003330000000000000000000000000000001
1000000000000022200000000000000000000000000000000000000000033300000001
1000000000000000000000000000000000000000000000000000000000000000000001
1000000000000000000000110000000000000000000000000000000022200000060001
1000000000000000000000000000000000000000001100000000000000000001111101
1700000000000000000000000000006000000000000000000000000000000000000001
1111100000000000000000000001111110000000000000000000000000000000000001
1000000000000000000000000000000000000000000000000600000000000000000001
1000000000060000000000000000000000033300000011111100000000000000000001
1000000011111100000000000000000000000000000000000000000000000000000001
1000000000000000003330000000000000000000000000000000000000060000000001
1000000000000000000000000000000000000000000000000000000011111000000001
1000000000000000000000000022200000000000000000000000000000000000000001
1000000000000000000000000000000000000000000000000000000000000000000001
1000000000000000000000000000000000000060000000000000000000000000000001
1000000000000000000000000000000000001111100000000000000000000000000001
1000000000000000000000000000000000000000000000000000000000000000000001
1000004444000000000000000000000000000000000000004444000000000000000001
1111111111111111111111111111111111111111111111111111111111111111111111
